1111111111111111111111111111111111111111
10000000000000000000C0000000000000000001
1000111000000000000011111100000000110001
1000C0000000000000000011111000000111C001
1000011000001110000001100000000000010001
1000000000010C00000000000000011000000001
1000100000000000000001010000110C00000001
1000P010000000000010110E1000010000100001
1000000000000000000001100000000000000001
1111111111111111111111111111111111111111