11111111111111111111111111111111111111111111111
1P0000000C00000000C000000000000000C0000000000E1
10011111100111111001111110001111100111000011101
10110000001100001101100011011000110111100111101
10110000001100001101100011011111110110111101101
10110000001100001101100011011000110110011001101
10011111100111111001111110011000110110000001101
100000000000000000C0000000C0000000C000000000001
11111111111111111111111111111111111111111111111